11111111111111111111111111
1E00000000000C000000000001
10100101001000001000010101
10100100101010100010010001
1P0000000C00C00000000000C1
11111111111111111111111111