1111111111111
1001000000001
1000011111001
100011P00E001
1111111111111