1111111111111
1P010000000C1
1000011111001
1C0011C000001
1111111111111