11111111111111111111
100010000000000000P1
10000000110000001001
1E00110000000C000001
11111111111111111111