11111111111111111111
10001000000000000001
100000P0110000001001
1E00110000000C000001
11111111111111111111